# # # # # # # # # # # # #
#                       #
#                       #
#                       #
#                       #
#                       #
#                       #
#                       #
#                       #
#                       #
#                       #
#               @       #
# # # # # # # # # # # # #