# # # # # # # # # # # # #
#                       #
#                       #
#                       #
#                       #
#                       #
#               # # # # #
#                       #
#                       #
#                       #
#                       #
#                       #
# # # # # # # # # # # # #