# # # # # # # # # #
#                 #
#                 #
#                 #
#                 #
#                 #
#                 #
#                 #
#                 #
#                 #
#                 #
#               @ #
# # # # # # # # # #