# # # # # # # # # # # # #
#                       #
#                       #
#                       #
#                       #
#                       #
#                       #
#                       #
#                       #
#                       #
#                       #
#                 @     #
# # # # # # # # # # # # #