#     # # # # # # # # # # # # # # # # # # # # # # # # # # # # # # # # # # # # # # # # # # #
#                                               # ^ #                                     #
#                                                                                         #
#                                                                                         #
#                                                                                         #
#                                                                                         #
#   *                                                                                     #
# # # # #                               *                                                 #
#           # # # #             # # # # # # #                         *                   #
#                  *                                # & #         # # # # # # #           #
#   # # # # #     # # # # #                   # #   #   #                                 #
#                *                    *             #   #          *                    $ #
# # # # # # # # # # # # # # # # # # # # # # # # # # #   # # # # # # # # # # # # # # # # # #