# # # # # # # # # # # # #
#                       #
#                       #
#                       #
#                       #
#                       #
#                       #
#                       #
#                       #
#                       #
#                       #
#                    $  #
# # # # # # # # # # # # #