#     # # # # # # # # # # # # # # # # # # # # # # # # # # # # # # # # # # # # # # # # # # # # # # # # # # # # # # # # # # # # # # # # # # # # # # # # # # # # # # # # # # # # # # # # # # # # # # # # # # # # # # # # # # # # # # # # # # # # # # # # # # # # # # # # # # # # #
#                                               # ^ #                                                                                      # ^ #         # ^ #        # ^ #        # ^ #                                                                                      #
#                                                                                                                                                                                                                                                                             #
#                                                                                                                                                                                                                                                                        $    #
#                                                                                                                                                                                                                                                                     # # # # #
#                                                                                                                     *                                                                                *                              *                                       #
#                                                                                                           # # # # # # #               # # # # # # #                                         # # # # # # #                  # # # # # # #                                    #
#                                       *                                                                                                                                                  *                                                                 # # # # #        #
#           # # # #             # # # # # # #                         *                                                  *                  *                            # # # # # # # # # # # # # #                                                                          #
#                  *                                # & #         # # # # # # #                               # # # # # # #            # # # # # # #                                                                  *                          # # # # # # #                #
#                # # # # #                   # #    #   #                                                                                                # # # # # # #                                       # # # # # # #                                                    #
#                *                    *             #   #          *                               *                                          *                                                      *                                       *              *                 #
# # # # # # # # # # # # # # # # # # # # # # # # # # #   # # # # # # # # # # # # # # # # # # # # # # # # # # # # # # # # # # # # # # # # # # # # # # # # # # # # # # # # # # # # # # # # # # # # # # # # # # # # # # # # # # # # # # # # # # # # # # # # # # # # # # # # # # # #