#     # # # # # # # # # # # # # # # # # # # # # # # # # # # # # # # # # # # # # # # # # # #
#                                               # ^ #                                     #
#                                                                                         #
#                                                                                         #
#                                                                                         #
#                                                                                         #
#   *                                                                                     #
# # # # #                               *                                                 #
#           # # # #             # # # # # # #                         *                   #
#           #     #                                 # & #         # # # # # # #           #
#   # # # # #     # # # # #                         #   #                                 #
#   #     #         #     #                         #   #                               $ #
# # # # # # # # # # # # # # # # # # # # # # # # # # #   # # # # # # # # # # # # # # # # # #